Stage 2
20
game_fon3.jpg
111111111111111111111111111111
100000000000000000000000000001
105000000000000000000000000001
111113112121220000000000000001
100003000000000000000000000001
100113000000000000000000000001
100223444444444444600000000001
100223000000000001122211311221
111111300000000000000000300001
100000300000000000000000300001
100000111131111111100000300001
100000000034444444400000311111
111100000030000003004444300001
100000000030001113110000300001
160000000030001223110000300001
122113111111001111110000300001
100003000000000000000000300001
100003000003111121221122110001
100003000003000044440000000001
100003000112221300000000113001
100003000111111300011111113001
111111111111111111111111111111
