Stage 2
20
111111111111111111111111111111
100000000000000000000000000001
100000000000000000000000000001
111112111111110000000000000001
100002000000000000000000000001
100112000000000000000000000001
100112333333333333000000000001
100112000000000001111111211111
111111200000000000000000200001
100000200000000000000000200001
100000111121111111100000200001
100000000023333333300000211111
111100000020000002003333200001
100000000020001112110000200001
100000000020001112110000200001
111112111111001111110000200001
100002000000000000000000200001
100002000002111111111111110001
100002000002000000000000000001
100002000111111200000000112001
100002000111111240011111112001
111111111111111111111111111111