Stage 1
10
game_fon3.jpg
111111111111111111111111111111
100000000000000000000000000001
100000600000000000000000000001
121111131122210000000000000001
100000034444444444440000000001
100000030000011300011112213111
100000030000011300000000003001
111311110000011111111311111111
100300000000000000000300000001
111222211113111111111300000001
100000000003000000000300000001
100000000003444444444300000001
100000311111000000000111122131
160000300005000000000000000031
111111111111111111111111111111