Final level!
30
fon1.jpg
1111111111111111111111111111111111111111
1001000000001444444444444444444444444441
1051000000000000030011113000000030000001
1221000004444000030001111110001130002201
1000000110000100032220001000000130010011
1000000440000000030011101000060130002201
1000001001000000034400041111111111300001
1000000000000000030011100000000000310611
1111111111000000030011144444444100311111
1114444444013000030011100444044440300001
1110000000003000030000113000100003111111
1112221000003111110000003000000003000001
1110001000003111111112223444444443121131
1112221000003000000010001000001101000131
1110001000011111113010001000001101111131
1112221000000000003012221000001100000031
1100000000000000003000000000001101111131
1100000000000000003000000000001100000031
1111111111111111111111111111111111111111