Stage 1
10
111111111111111111111111111111
100000000000000000000000000001
100000500000000000000000000001
111111121111110000000000000001
100000023333333333330000000001
100000020000011200011111112111
100000020000011200000000002001
111211110000011111111211111111
100200000000000000000200000001
111111111112111111111200000001
100000000002000000000200000001
100000000002333333333200000001
100000211111000000000111111121
150000200004000000000000000021
111111111111111111111111111111